###############
#     x@  e   #
#bb  r      bb#
#bb    a r  bb#
#    a        #
#         e a #
#  r   1   a  #
#   e         #
#          e  #
#      b    a #
# r           #
#    b    b   #
#####     #####
#*hao  1  oah*#
###############
